+--+--+--+--+--+--+--+--+--+--+
|p       |           |        |
+--+  +--+  +--+  +  +  +--+  +
|     |     |     |  |  |  |  |
+  +  +  +--+  +--+  +  +  +--+
|  |  |  |  |  |     |  |     |
+  +--+  +  +  +--+  +  +  +  +
|  |     |  |     |  |     |  |
+  +  +--+  +--+  +  +--+--+  +
|     |        |  |  |     |  |
+  +--+--+--+  +  +  +  +  +  +
|     |        |  |     |  |  |
+--+  +  +--+  +  +--+--+  +  +
|  |  |  |     |  |        |  |
+  +  +  +--+  +  +--+--+--+  +
|     |     |  |  |        |  |
+  +--+--+  +  +  +  +--+  +  +
|  |        |  |  |  |  |  |  |
+  +  +--+--+  +  +  +  +  +  +
|     |        |        |    g|
+--+--+--+--+--+--+--+--+--+--+


